7 14

2   2   12  5   13  2   2   
-1  -1  1   12  6   -1  -1  
-1  -1  -1  1   3   -1  -1  
-1  -1  -1  -1  -1  -1  -1  
-1  -1  -1  -1  -1  -1  -1  
-1  -1  -1  -1  -1  -1  -1  
-1  -1  -1  -1  -1  -1  -1  
-1  -1  -1  -1  -1  -1  -1  
-1  -1  7   8   8   8   9   
-1  -1  4   5   5   5   6   
-1  7   10  5   5   5   6   
7   10  5   5   5   5   6   
4   5   5   5   5   5   6   
4   5   5   5   5   5   6   