60 21
6   0   0   0   0   0   0   0   0   0   0   0   4   5   5   13  2   2   2   2   2   2   2   2   2   2   2   2   2   2   2   2   2   2   2   2   2   2   2   2   2   2   2   2   2   2   2   2   2   2   2   2   2   2   2   4   5   5   5   5                 
6   0   0   0   0   0   0   0   0   0   0   0   4   5   5   6   0   0   0   0   0   0   0   0   0   0   0   0   0   0   0   0   0   0   0   0   0   0   0   0   0   0   0   0   0   0   0   0   0   0   0   0   0   0   0   4   5   5   5   5                 
6   0   0   0   0   0   0   0   0   0   0   0   4   5   5   6   0   0   0   0   0   0   0   0   0   0   0   0   0   0   0   0   0   0   0   0   0   0   0   0   0   0   0   0   0   0   0   0   0   0   0   0   0   0   0   4   5   5   5   5                 
6   8   8   8   8   9   0   0   0   0   0   0   4   5   5   11  9   0   0   0   0   0   0   0   0   0   0   0   0   0   0   0   0   0   0   0   0   0   0   0   0   0   0   0   0   0   0   0   0   0   0   0   0   0   0   4   5   5   5   5                 
6   5   5   5   5   6   0   0   0   0   0   0   4   5   5   5   6   0   0   0   0   0   0   0   0   0   0   0   0   0   0   0   0   0   0   0   0   0   0   0   0   0   0   0   0   0   0   0   0   0   0   0   0   0   0   4   5   5   5   5                 
6   5   5   5   5   11  9   0   0   0   0   0   4   5   5   5   6   0   0   8   8   8   8   8   8   8   8   8   8   8   8   8   8   8   8   8   8   8   8   9   0   0   0   0   0   0   0   0   0   0   0   0   0   0   0   4   5   5   5   5                 
6   5   5   5   5   5   6   0   0   0   0   0   4   5   5   5   6   0   0   5   5   5   5   5   5   5   5   5   5   5   5   5   5   5   5   5   5   5   5   6   0   0   0   0   0   0   0   0   0   0   0   0   0   0   0   4   5   5   5   5                 
6   5   5   5   5   5   11  9   0   0   0   0   4   5   5   5   6   0   0   0   0   0   0   0   0   0   0   0   0   0   0   0   5   5   5   5   5   5   5   6   0   0   0   0   0   0   0   0   0   0   0   0   0   0   0   4   5   5   5   5                 
6   5   5   5   5   5   5   11  9   0   0   0   4   5   5   5   6   0   0   0   0   0   0   0   0   0   0   0   0   0   0   0   5   5   5   5   5   5   5   6   0   0   0   0   0   0   0   0   0   0   0   0   0   0   0   4   5   5   5   5                 
6   5   5   5   5   5   5   13  3   0   0   0   4   5   5   13  3   0   0   0   0   0   0   0   0   0   0   0   0   0   0   0   5   5   5   5   5   5   5   6   0   0   0   0   0   0   0   0   0   0   0   0   0   0   0   4   5   5   5   5                 
6   5   5   5   5   5   5   6   0   0   0   0   4   5   5   6   0   0   0   0   0   0   0   0   0   0   0   0   0   0   0   0   5   5   5   5   5   5   5   11  8   8   8   8   8   8   8   8   8   9   0   0   0   0   0   4   5   5   5   5                   
6   5   5   5   5   5   5   6   0   0   0   5   5   5   5   6   0   0   0   0   0   0   0   0   0   0   0   0   0   0   0   0   2   2   2   2   2   2   2   2   2   2   2   2   2   2   2   2   2   3   0   0   0   0   0   4   5   5   5   5                   
6   5   5   5   5   5   5   6   0   0   0   5   5   5   5   6   0   0   0   0   0   0   0   0   0   0   0   0   0   0   0   0   0   0   0   0   0   0   0   0   0   0   0   0   0   0   0   0   0   0   0   0   0   0   0   4   5   5   5   5                   
6   5   5   5   5   5   5   6   0   0   0   5   5   5   5   6   0   0   0   0   0   0   0   0   0   0   0   0   0   0   0   0   0   0   0   0   0   0   0   0   0   0   0   0   0   0   0   0   0   0   0   0   0   0   0   4   5   5   5   5                   
6   5   5   5   5   5   5   6   0   0   0   5   5   5   13  3   0   0   0   0   0   0   0   0   0   0   0   0   0   0   0   0   0   0   0   0   0   0   0   0   0   0   0   0   0   0   0   0   0   0   0   0   0   0   0   4   5   5   5   5                   
6   5   5   5   5   5   5   6   0   0   0   5   5   13  3   0   0   0   0   0   0   0   0   0   0   0   0   0   0   0   0   0   0   0   0   0   0   0   0   0   0   0   0   0   0   0   0   0   0   0   0   0   0   0   0   4   5   5   5   5                 
6   5   5   5   5   5   5   6   0   0   5   5   5   0   0   0   0   0   0   0   0   0   0   0   0   0   0   0   0   0   0   0   0   0   0   0   0   0   0   0   0   0   0   0   0   0   0   0   0   0   0   0   0   0   0   4   5   5   5   5                 
6   5   5   5   5   5   5   6   0   0   0   0   0   0   0   0   0   0   0   0   0   0   0   0   0   0   0   0   0   0   0   0   0   0   0   0   0   0   0   0   0   0   0   0   0   0   0   0   0   0   0   0   0   0   0   4   5   5   5   5                 
6   5   5   5   5   5   5   6   0   0   0   0   0   0   0   0   0   0   0   0   0   0   0   0   0   0   0   0   0   0   0   0   0   0   0   0   0   0   0   0   0   0   0   0   0   0   0   0   0   0   0   0   0   0   0   4   5   5   5   5                 
6   5   5   5   5   5   5   6   0   0   0   0   0   0   0   0   0   0   0   0   0   0   0   0   0   0   0   0   0   0   0   0   0   0   0   0   0   0   0   0   0   0   0   0   0   0   0   0   0   0   0   0   0   0   0   4   5   5   5   5                 
6   5   5   5   5   5   5   11  8   8   8   8   8   8   8   8   8   8   8   8   8   8   8   8   8   8   8   8   8   8   8   8   8   8   8   8   8   8   8   8   8   8   8   8   8   8   8   8   8   8   8   8   8   8   8   4   5   5   5   5                 