14 5
1 1 1 1 1 1 0 1 1 4 1 1 2 2
0 3 3 3 0 1 3 2 2 0 3 2 0 3 
2 0 3 2 1 0 0 4 0 0 4 2 0 1
0 0 0 0 0 1 1 1 2 2 2 2 0 0  
1 2 3 2 1 2 1 3 2 0 1 2 3 2 