5 5
1 1 1 1 1
0 3 3 3 0
0 0 4 0 0
0 0 0 0 0
1 2 3 2 1